hum	jhu.hap.hum@gmail.com
spring fair	springfair@jhu.edu
jhu voice for life	prolife@jhu.edu
science fiction and fantasy club	hopsfa@jhu.edu
knotty by nature	jhu.knottybynature@gmail.com
sikh	mnagpal1
jhu debate team	johnshopkinsdebate@gmail.com
ivan zhang	izhang4@jhu.edu
sigma chi	ky.sigchi@gmail.com
jhu newsletter	managing@jhunewsletter.com
committee on student elections§	sga@jhu.edu
the hop§	hopcochairs@gmail.com
hands on fiber arts§	bma11@jhu.edu
lem	hopkins.lem@gmail.com
wjhu	wjhumanager@gmail.com
daon mclarin johnson	djohn236@jhmi.edu
hands on fiberarts	bma11@jhu.edu
hands on fiber art	bma11@jhu.edu
fas	jhufas@gmail.com
band	band@jhu.edu
student org public health stu	jhuphsf@jhu.edu
liz pence	epence2@jhu.edu
ecelectics	jhu.eclectics@gmail.com
ballroom dance	jhuballroom@gmail.com
fas (3 packages)	jhufas@gmail.com
vivas	vivaz06@gmail.com
jhumonk	sec-gen@jhumunc.org
catholic community	catholic@jhu.edu
ballet	jhuballet@gmail.com
wind ensemble	band@jhu.edu
vivaz	vivaz06@gmail.com
music dynasty	hopkinsmusicdynasty@gmail.com
cooking club	jhucooking@gmail.com
zinda	jhuzinda@gmail.com
students for justice in palestine	hopkinssjp@gmail.com
ataxia ambassadors	mchang45@jhu.edu
jhu ladybirds	jhuladybirds@gmail.com
refuel our future	jhu.refuelourfuture@gmail.com
senior class council	sga@jhu.edu
johncon	johnconforever@gmail.com
johns hopkins news-letter	managing@jhunewsletter.com
kranti	johnshopkinskranti@gmail.com
students for environmental action	hopkins.sea@gmail.com
jacqueline morton lan yun blue orchids	lanyunblueorchids@gmail.com
oriental music	jhuorientalmusic@gmail.com
sophomore class council	sga@jhu.edu
lion dance	yonghanldt@gmail.com
homewood united for music	jhu.hap.hum@gmail.com
blue-jay bhattalion	kehlert1@jhu.edu
bands	band@jhu.edu
notes of ranvier	notesofranvierjhu@gmail.com
jacqueline morton- dsaga	dsaga@jhu.edu
hopkins sci fiction	hopsfa@jhu.edu
jaywalk	jhujaywalk@gmail.com
muslim association	jhuma@jhu.edu
kross	jlee583@jhu.edu
global china connection	lisa.xiao@jhu.edu
ataxia	mchang45@jhu.edu
esports	jhuesports@gmail.com
hopkins feminists	hopkinsfeminists@gmail.com
pre-dental society	zchen51@jhu.edu
smash	smashatjhu@gmail.com
carolyn marar	cmarar1@jhu.edu
ladybirds	jhuladybirds@gmail.com
maryland alpha, michael farid	mfarid2@jhu.edu
johns hopkins news letter	managing@jhunewsletter.com
sam & rollin fossum newsletter	error
latino pre health	hopkins.lem@gmail.com
interasian counsel	jhu@campkesem.org
lady birds dance team§	jhuladybirds@gmail.com
hoptoberfest	hoptoberfest@jhu.edu
classical ballet	jhuballet@gmail.com
eclectics	jhu.eclectics@gmail.com
jhu-munc	sec-gen@jhumunc.org
crystal hooper	chooper
entertainers club	jpinker3@jhu.edu
josh	joshjohnshopkins@gmail.com
society for woman engineering	aiche.hopkins@gmail.com
ballet co	jhuballet@gmail.com
baila	jhubaila@gmail.com
jhec	jpinker3@jhu.edu
korean pop motion	korean.pop.motion@gmail.com
the hop	thehop@jhu.edu
chess club	bpikus1@jhu.edu
mock trial	hopkinstrial@gmail.com
blossom ogunyinka	null
science fiction and fantasy association	hopsfa@jhu.edu
tedxjhu	rbao1@jhu.edu
entertainer's club	jpinker3@jhu.edu
women's prehealth leadership	wphls.jhu@gmail.com
alpha phi omega	jhu.apo.president@gmail.com
jackie morton	jackie
mse	msesymposium@jhu.edu
phsf	jhuphsf@jhu.edu
triple helix	jhu@thetriplehelix.org
sustainable hopkins innovative project	qxu30@jhu.edu
public health student forum	jhuphsf@jhu.edu
hopkins pen and paper gaming club	hopkinspenpapergaming@gmail.com
kappa kappa gamma	president.he.kkg@gmail.com
ballet company	jhuballet@gmail.com
epidemic proportions	epidemicproportions@gmail.com
choral society	jhuchoralsociety@gmail.com
public health student forum§	jhuphsf@jhu.edu
adina estrin§	aestrin1@jhu.edu
allnighters	jhuallnighters@gmail.com
humming jay	humming.jay.jhu@gmail.com
sga	sga@jhu.edu
dance department	idk
jason timmerman	jtimmer3@jhu.edu
hopkins sci fic	hopsfa@jhu.edu
dasaga	dsaga@jhu.edu
jhu magic	jhumagic@gmail.com
hands on fiber arts	bma11@jhu.edu
jmag	jmagazine@gmail.com
dance marathon§	dancemarathon@jhu.edu
jhu magazine	jmagazine@gmail.com
william roche	wroche@jhu.edu
parnerts in health engage	humhijhu@gmail.com
hopkins emergency response unit	hero_captain@jhu.edu
bj bhatallian	kehlert1@jhu.edu
jhumunc	sec-gen@jhumunc.org
global medical brigades	jhu.gmb@gmail.com
women's prehealth leadership society	wphls.jhu@gmail.com
kpm	korean.pop.motion@gmail.com
jhu slam	slam.jhu@gmail.com
dance marathon	dancemarathon@jhu.edu
stand up comedy	nscandu1@jhu.edu
circle k	jhu.circlek.1@gmail.com
ciatlin tumey	ctumey@jhu.edu
committee on student elections	sga@jhu.edu
jhudc	johnshopkinsdebate@gmail.com
mse symposium	msesymposium@jhu.edu
medical ethics discussion panel	jhumedpanel@gmail.com
lambda epsilon	hopkins.lem@gmail.com
claire beaver	cbeaver1@jhu.edu
jhu choral society	jhuchoralsociety@gmail.com
wphls	wphls.jhu@gmail.com
sga- mi tu	sga@jhu.edu
jhu debate council	johnshopkinsdebate@gmail.com
dsaga	dsaga@jhu.edu
barnstormers	jhubarnstormers@gmail.com
aed	aedjhu@gmail.com
marque magazine	marquemagazineofficial@gmail.com
wjhu radio	wjhumanager@gmail.com
jhu foreign affairs symposium	jhufas@gmail.com
buttered niblets	ull,"description":"<p>we are a group of jhu students who work tirelessly to produce the finest quality impovised comedy (fqic).&nbsp; we do shows roughly once a month, usually in the arellano theater.</p>\r\n<p>our facebook page is the best place to find current information about us and what we're up to -- we'll be like any other facebook friend, except with more fqic.</p>\r\n<p>come see us perform in arellano in the first few weeks of school. if you like us, auditions should be held the same weekend. we'd love to see you there!</p>
alpha epsilon delta	aedjhu@gmail.com
hero	hero_captain@jhu.edu
inter asian counsel ( iac@jhu.edu)	iac@jhu.edu
kendo	tkim80@jhu.edu
intervarsity christian	intervarsityjhu@gmail.com
jmunc	sec-gen@jhumunc.org
betty addisson	baddiso3@jhu.edu
508-923-4973	unknown
adina estrin	aestrin1@jhu.edu
epidemic pro	epidemicproportions@gmail.com
yong han lion dance troupe	yonghanldt@gmail.com
elena debold	elena.debold@jhu.edu
medlife	medlife.jhu@gmail.com
public health	jhuphsf@jhu.edu
jacqueline morton	a
muslim students association	jhuma@jhu.edu
hopkins spring fair - arts and crafts commitee§	springfair@jhu.edu
caitlintumey	caitlin
throat culture	sfreyma3@jhu.edu
jhu band	band@jhu.edu
caitlin tumey	ctumey@jhu.edu
temps d'afrique	tmpsdfrq.jhu@gmail.com
junior class council	sga@jhu.edu
gro	gro@jhu.edu
hindu students	idk
jackie morton - jhu band	band@jhu.edu
students for environ action	hopkins.sea@gmail.com
jhunions	jhunions@jhu.edu
model un	sec-gen@jhumunc.org
jay walk	jhujaywalk@gmail.com
leslie barnell	jhu.quidditch@gmail.com
jason timmerman§	jtimmer3@jhu.edu
sustainable hopkins initiative proj	qxu30@jhu.edu
shine	shine.jhu@gmail.com
european horizon	hopkins.europeanhorizons@gmail.com
students for justince in palestine	hopkinssjp@gmail.com
student org-gro	gro@jhu.edu
tedx	rbao1@jhu.edu
debate council	johnshopkinsdebate@gmail.com
indian graduate students	igsa.board@gmail.com
juliette klitz	jklitz1@jhu.edu
anisha anand	aanand10@jhu.edu
partners in health engage	pih.homewood@gmail.com
hopkins science fiction	hopsfa@jhu.edu
math club	mathclub.jhu@gmail.com
